TESTLEVELSTATE
testtileset
40 30
*
zzzzzzzzzzzzzzzzzzzzzzzzzzzzzzzzzzzzzzzz
z                                      z
z                                      z
z                                      z
z                                      z
z                                      z
z                                      z
z                                      z
z                                      z
z                                      z
z                                      z
z                                      z
z                                      z
z                                      z
z                                      z
z     z   z z  z zzz                   z
z     z z z z  z  z                    z
z      z z   zz   z                    z
z                                      z
z                                      z
z                                      z
z                                      z
z                                      z
z                                      z
z                                      z
z                                      z
z                                      z
z                                      z
z                                      z
zzzzzzzzzzzzzzzzzzzzzzzzzzzzzzzzzzzzzzzz
*
this object data isn't interpreted yet
*
this link data isn't interpreted yet
